"filename", "language", "TypeScript", "TypeScript JSX", "comment", "blank", "total"
"c:\Users\dell\WebstormProjects\Gigsy_Digitopia2025\gigsy\convex\_generated\api.d.ts", "TypeScript", 2, 0, 0, 0, 2
"c:\Users\dell\WebstormProjects\Gigsy_Digitopia2025\gigsy\convex\profile.ts", "TypeScript", 558, 0, 0, 74, 632
"c:\Users\dell\WebstormProjects\Gigsy_Digitopia2025\gigsy\convex\schema.ts", "TypeScript", 7, 0, 0, 0, 7
"c:\Users\dell\WebstormProjects\Gigsy_Digitopia2025\gigsy\convex\users.ts", "TypeScript", 12, 0, 0, 0, 12
"c:\Users\dell\WebstormProjects\Gigsy_Digitopia2025\gigsy\shared\profile\profileCreationSchema.ts", "TypeScript", 209, 0, 0, 18, 227
"c:\Users\dell\WebstormProjects\Gigsy_Digitopia2025\gigsy\src\app\app\profile\[profileId]\actions.ts", "TypeScript", 39, 0, 0, 12, 51
"c:\Users\dell\WebstormProjects\Gigsy_Digitopia2025\gigsy\src\app\app\profile\[profileId]\page.tsx", "TypeScript JSX", 0, 39, 0, 6, 45
"c:\Users\dell\WebstormProjects\Gigsy_Digitopia2025\gigsy\src\components\AppSidebar.tsx", "TypeScript JSX", 0, 7, 0, 0, 7
"c:\Users\dell\WebstormProjects\Gigsy_Digitopia2025\gigsy\src\components\ProfileAbout\ProfileAbout.ui.tsx", "TypeScript JSX", 0, 3, 0, 0, 3
"c:\Users\dell\WebstormProjects\Gigsy_Digitopia2025\gigsy\src\components\ProfileEducation\ProfileEducation.ui.tsx", "TypeScript JSX", 0, 3, 0, 0, 3
"c:\Users\dell\WebstormProjects\Gigsy_Digitopia2025\gigsy\src\components\ProfileExperience\ProfileExperience.ui.tsx", "TypeScript JSX", 0, 15, 0, 0, 15
"c:\Users\dell\WebstormProjects\Gigsy_Digitopia2025\gigsy\src\components\ProfileHeader\ProfileHeader.container.tsx", "TypeScript JSX", 0, 3, 0, 0, 3
"c:\Users\dell\WebstormProjects\Gigsy_Digitopia2025\gigsy\src\components\ProfileHeader\ProfileHeader.ui.tsx", "TypeScript JSX", 0, 17, 0, 0, 17
"c:\Users\dell\WebstormProjects\Gigsy_Digitopia2025\gigsy\src\components\ProfileLanguages\ProfileLanguages.ui.tsx", "TypeScript JSX", 0, 4, 0, 0, 4
"c:\Users\dell\WebstormProjects\Gigsy_Digitopia2025\gigsy\src\components\ProfilePortfolio\ProfilePortfolio.ui.tsx", "TypeScript JSX", 0, 20, 0, 0, 20
"c:\Users\dell\WebstormProjects\Gigsy_Digitopia2025\gigsy\src\components\ProfileSidebar\ProfileSidebar.ui.tsx", "TypeScript JSX", 0, 21, 0, 0, 21
"c:\Users\dell\WebstormProjects\Gigsy_Digitopia2025\gigsy\src\components\profile-onboarding\ProfileOnboarding.tsx", "TypeScript JSX", 0, 39, 0, 5, 44
"c:\Users\dell\WebstormProjects\Gigsy_Digitopia2025\gigsy\src\components\profile-onboarding\ProfileOnboardingForm.tsx", "TypeScript JSX", 0, 552, 0, 35, 587
"c:\Users\dell\WebstormProjects\Gigsy_Digitopia2025\gigsy\src\services\profile\ProfileRepository.ts", "TypeScript", 76, 0, 5, 14, 95
"c:\Users\dell\WebstormProjects\Gigsy_Digitopia2025\gigsy\src\services\profile\ProfileService.ts", "TypeScript", 34, 0, 0, 4, 38
"c:\Users\dell\WebstormProjects\Gigsy_Digitopia2025\gigsy\src\services\profile\profileFetchers.ts", "TypeScript", 108, 0, 0, 18, 126
"Total", "-", 1045, 723, 5, 186, 1959