"filename", "language", "Markdown", "TypeScript JSX", "TypeScript", "comment", "blank", "total"
"c:\Users\dell\WebstormProjects\Gigsy_Digitopia2025\gigsy\.github\instructions\Jotai.instructions.md", "Markdown", -5, 0, 0, 0, -2, -7
"c:\Users\dell\WebstormProjects\Gigsy_Digitopia2025\gigsy\.github\instructions\containerization-docker-best-practices.instructions.md", "Markdown", -604, 0, 0, -1, -77, -682
"c:\Users\dell\WebstormProjects\Gigsy_Digitopia2025\gigsy\.github\instructions\draft\Jotai.instructions.md", "Markdown", 5, 0, 0, 0, 2, 7
"c:\Users\dell\WebstormProjects\Gigsy_Digitopia2025\gigsy\.github\instructions\draft\containerization-docker-best-practices.instructions.md", "Markdown", 604, 0, 0, 1, 77, 682
"c:\Users\dell\WebstormProjects\Gigsy_Digitopia2025\gigsy\.github\instructions\draft\github-actions-ci-cd-best-practices.instructions.md", "Markdown", 551, 0, 0, 1, 56, 608
"c:\Users\dell\WebstormProjects\Gigsy_Digitopia2025\gigsy\.github\instructions\draft\jest.instructions.md", "Markdown", 494, 0, 0, 0, 124, 618
"c:\Users\dell\WebstormProjects\Gigsy_Digitopia2025\gigsy\.github\instructions\draft\markdown.instructions.md", "Markdown", 41, 0, 0, 0, 12, 53
"c:\Users\dell\WebstormProjects\Gigsy_Digitopia2025\gigsy\.github\instructions\draft\memory-bank.instructions.md", "Markdown", 232, 0, 0, 0, 67, 299
"c:\Users\dell\WebstormProjects\Gigsy_Digitopia2025\gigsy\.github\instructions\draft\sentry.instructions.md", "Markdown", 261, 0, 0, 0, 73, 334
"c:\Users\dell\WebstormProjects\Gigsy_Digitopia2025\gigsy\.github\instructions\draft\tailwind.instructions.md", "Markdown", 451, 0, 0, 0, 89, 540
"c:\Users\dell\WebstormProjects\Gigsy_Digitopia2025\gigsy\.github\instructions\draft\zod.instructions.md", "Markdown", 249, 0, 0, 0, 65, 314
"c:\Users\dell\WebstormProjects\Gigsy_Digitopia2025\gigsy\.github\instructions\github-actions-ci-cd-best-practices.instructions.md", "Markdown", -551, 0, 0, -1, -56, -608
"c:\Users\dell\WebstormProjects\Gigsy_Digitopia2025\gigsy\.github\instructions\jest.instructions.md", "Markdown", -494, 0, 0, 0, -124, -618
"c:\Users\dell\WebstormProjects\Gigsy_Digitopia2025\gigsy\.github\instructions\markdown.instructions.md", "Markdown", -41, 0, 0, 0, -12, -53
"c:\Users\dell\WebstormProjects\Gigsy_Digitopia2025\gigsy\.github\instructions\memory-bank.instructions.md", "Markdown", -232, 0, 0, 0, -67, -299
"c:\Users\dell\WebstormProjects\Gigsy_Digitopia2025\gigsy\.github\instructions\sentry.instructions.md", "Markdown", -261, 0, 0, 0, -73, -334
"c:\Users\dell\WebstormProjects\Gigsy_Digitopia2025\gigsy\.github\instructions\tailwind.instructions.md", "Markdown", -451, 0, 0, 0, -89, -540
"c:\Users\dell\WebstormProjects\Gigsy_Digitopia2025\gigsy\.github\instructions\zod.instructions.md", "Markdown", -249, 0, 0, 0, -65, -314
"c:\Users\dell\WebstormProjects\Gigsy_Digitopia2025\gigsy\LMS_QA_CHECKLIST.md", "Markdown", 200, 0, 0, 0, 43, 243
"c:\Users\dell\WebstormProjects\Gigsy_Digitopia2025\gigsy\LMS_README.md", "Markdown", 319, 0, 0, 0, 65, 384
"c:\Users\dell\WebstormProjects\Gigsy_Digitopia2025\gigsy\src\app\app\courses\CourseCatalogWrapper.tsx", "TypeScript JSX", 0, 273, 0, 28, 28, 329
"c:\Users\dell\WebstormProjects\Gigsy_Digitopia2025\gigsy\src\app\app\courses\[courseId]\CourseDetailsWrapper.tsx", "TypeScript JSX", 0, 157, 0, 10, 18, 185
"c:\Users\dell\WebstormProjects\Gigsy_Digitopia2025\gigsy\src\app\app\courses\[courseId]\lessons\[lessonId]\LessonClientWrapper.tsx", "TypeScript JSX", 0, 103, 0, 38, 15, 156
"c:\Users\dell\WebstormProjects\Gigsy_Digitopia2025\gigsy\src\app\app\courses\[courseId]\lessons\[lessonId]\page.tsx", "TypeScript JSX", 0, 232, 0, 39, 35, 306
"c:\Users\dell\WebstormProjects\Gigsy_Digitopia2025\gigsy\src\app\app\courses\[courseId]\modules\[moduleId]\lessons\[lessonId]\page.tsx", "TypeScript JSX", 0, 31, 0, 10, 6, 47
"c:\Users\dell\WebstormProjects\Gigsy_Digitopia2025\gigsy\src\app\app\courses\[courseId]\page-fixed.tsx", "TypeScript JSX", 0, 23, 0, 15, 6, 44
"c:\Users\dell\WebstormProjects\Gigsy_Digitopia2025\gigsy\src\app\app\courses\[courseId]\page-new.tsx", "TypeScript JSX", 0, 70, 0, 20, 11, 101
"c:\Users\dell\WebstormProjects\Gigsy_Digitopia2025\gigsy\src\app\app\courses\[courseId]\page.tsx", "TypeScript JSX", 0, -194, 0, -8, -18, -220
"c:\Users\dell\WebstormProjects\Gigsy_Digitopia2025\gigsy\src\app\app\courses\page.tsx", "TypeScript JSX", 0, -280, 0, -28, -31, -339
"c:\Users\dell\WebstormProjects\Gigsy_Digitopia2025\gigsy\src\components\admin\AdminCourseForm.tsx", "TypeScript JSX", 0, 62, 0, 9, 8, 79
"c:\Users\dell\WebstormProjects\Gigsy_Digitopia2025\gigsy\src\components\course\CourseHero.stories.tsx", "TypeScript JSX", 0, 112, 0, 9, 8, 129
"c:\Users\dell\WebstormProjects\Gigsy_Digitopia2025\gigsy\src\components\course\CourseHero.tsx", "TypeScript JSX", 0, 272, 0, 25, 23, 320
"c:\Users\dell\WebstormProjects\Gigsy_Digitopia2025\gigsy\src\components\course\CourseSummaryCard.tsx", "TypeScript JSX", 0, 206, 0, 19, 20, 245
"c:\Users\dell\WebstormProjects\Gigsy_Digitopia2025\gigsy\src\components\course\ModuleList.stories.tsx", "TypeScript JSX", 0, 246, 0, 9, 15, 270
"c:\Users\dell\WebstormProjects\Gigsy_Digitopia2025\gigsy\src\components\course\ModuleList.tsx", "TypeScript JSX", 0, 303, 0, 27, 34, 364
"c:\Users\dell\WebstormProjects\Gigsy_Digitopia2025\gigsy\src\components\course\__tests__\CourseHero.test.tsx", "TypeScript JSX", 0, 89, 0, 7, 20, 116
"c:\Users\dell\WebstormProjects\Gigsy_Digitopia2025\gigsy\src\components\course\__tests__\ModuleList.test.tsx", "TypeScript JSX", 0, 130, 0, 10, 31, 171
"c:\Users\dell\WebstormProjects\Gigsy_Digitopia2025\gigsy\src\components\course\__tests__\integration.test.tsx", "TypeScript JSX", 0, 213, 0, 23, 35, 271
"c:\Users\dell\WebstormProjects\Gigsy_Digitopia2025\gigsy\src\components\kibo\EnhancedCourseVideoPlayer.tsx", "TypeScript JSX", 0, 8, 0, 1, 2, 11
"c:\Users\dell\WebstormProjects\Gigsy_Digitopia2025\gigsy\src\components\kibo\EnhancedCourseVideoPlayer_backup.tsx", "TypeScript JSX", 0, -553, 0, -65, -81, -699
"c:\Users\dell\WebstormProjects\Gigsy_Digitopia2025\gigsy\src\components\kibo\KiboVideoPlayer.tsx", "TypeScript JSX", 0, 13, 0, 0, 0, 13
"c:\Users\dell\WebstormProjects\Gigsy_Digitopia2025\gigsy\src\components\lesson\Comments.tsx", "TypeScript JSX", 0, 296, 0, 25, 34, 355
"c:\Users\dell\WebstormProjects\Gigsy_Digitopia2025\gigsy\src\components\lesson\LessonPlayer.stories.tsx", "TypeScript JSX", 0, 194, 0, 10, 15, 219
"c:\Users\dell\WebstormProjects\Gigsy_Digitopia2025\gigsy\src\components\lesson\LessonPlayer.tsx", "TypeScript JSX", 0, 412, 0, 29, 59, 500
"c:\Users\dell\WebstormProjects\Gigsy_Digitopia2025\gigsy\src\components\lesson\LessonSidebar.tsx", "TypeScript JSX", 0, 324, 0, 27, 28, 379
"c:\Users\dell\WebstormProjects\Gigsy_Digitopia2025\gigsy\src\components\lesson\LessonViewer.tsx", "TypeScript JSX", 0, 198, 0, 28, 34, 260
"c:\Users\dell\WebstormProjects\Gigsy_Digitopia2025\gigsy\src\components\lesson\__tests__\LessonPlayer.test.tsx", "TypeScript JSX", 0, 119, 0, 11, 27, 157
"c:\Users\dell\WebstormProjects\Gigsy_Digitopia2025\gigsy\src\components\lesson\index.ts", "TypeScript", 0, 0, 4, 5, 1, 10
"c:\Users\dell\WebstormProjects\Gigsy_Digitopia2025\gigsy\src\components\shared\FileUpload.tsx", "TypeScript JSX", 0, 20, 0, 4, 1, 25
"c:\Users\dell\WebstormProjects\Gigsy_Digitopia2025\gigsy\src\components\ui\AvatarStackWrapper.tsx", "TypeScript JSX", 0, 154, 0, 32, 21, 207
"c:\Users\dell\WebstormProjects\Gigsy_Digitopia2025\gigsy\src\components\ui\ProgressRadial.tsx", "TypeScript JSX", 0, 249, 0, 21, 19, 289
"c:\Users\dell\WebstormProjects\Gigsy_Digitopia2025\gigsy\src\components\ui\kibo-ui\avatar-stack\index.tsx", "TypeScript JSX", 0, 48, 0, 0, 4, 52
"c:\Users\dell\WebstormProjects\Gigsy_Digitopia2025\gigsy\src\components\ui\slider.tsx", "TypeScript JSX", 0, 37, 0, 6, 7, 50
"c:\Users\dell\WebstormProjects\Gigsy_Digitopia2025\gigsy\src\components\ui\textarea.tsx", "TypeScript JSX", 0, -1, 0, 0, 0, -1
"c:\Users\dell\WebstormProjects\Gigsy_Digitopia2025\gigsy\src\hooks\useProgress.ts", "TypeScript", 0, 0, 265, 42, 50, 357
"c:\Users\dell\WebstormProjects\Gigsy_Digitopia2025\gigsy\src\lib\performance\caching.ts", "TypeScript", 0, 0, 3, 6, 0, 9
"c:\Users\dell\WebstormProjects\Gigsy_Digitopia2025\gigsy\src\lib\performance\index.ts", "TypeScript", 0, 0, 4, 1, 1, 6
"c:\Users\dell\WebstormProjects\Gigsy_Digitopia2025\gigsy\src\lib\performance\monitoring.ts", "TypeScript", 0, 0, 34, 22, 6, 62
"c:\Users\dell\WebstormProjects\Gigsy_Digitopia2025\gigsy\src\lib\performance\video-optimization.ts", "TypeScript", 0, 0, 11, 8, 2, 21
"c:\Users\dell\WebstormProjects\Gigsy_Digitopia2025\gigsy\src\lib\video-player-utils.ts", "TypeScript", 0, 0, 1, 0, 1, 2
"c:\Users\dell\WebstormProjects\Gigsy_Digitopia2025\gigsy\src\schemas\course.ts", "TypeScript", 0, 0, 263, 26, 20, 309
"c:\Users\dell\WebstormProjects\Gigsy_Digitopia2025\gigsy\src\types\course.ts", "TypeScript", 0, 0, 200, 3, 13, 216
"c:\Users\dell\WebstormProjects\Gigsy_Digitopia2025\gigsy\src\utils\fetchers-client.ts", "TypeScript", 0, 0, 83, 28, 9, 120
"c:\Users\dell\WebstormProjects\Gigsy_Digitopia2025\gigsy\src\utils\fetchers-server.ts", "TypeScript", 0, 0, 311, 78, 41, 430
"c:\Users\dell\WebstormProjects\Gigsy_Digitopia2025\gigsy\src\utils\fetchers.ts", "TypeScript", 0, 0, 401, 113, 55, 569
"c:\Users\dell\WebstormProjects\Gigsy_Digitopia2025\gigsy\src\utils\format.ts", "TypeScript", 0, 0, 110, 94, 23, 227
"c:\Users\dell\WebstormProjects\Gigsy_Digitopia2025\gigsy\src\utils\time.ts", "TypeScript", 0, 0, 112, 69, 24, 205
"Total", "-", 519, 3566, 1802, 886, 788, 7561