"filename", "language", "TypeScript", "TypeScript JSX", "comment", "blank", "total"
"c:\Users\dell\WebstormProjects\Gigsy_Digitopia2025\gigsy\convex\courses.ts", "TypeScript", 955, 0, 151, 155, 1261
"c:\Users\dell\WebstormProjects\Gigsy_Digitopia2025\gigsy\src\app\api\users\webhook\route.ts", "TypeScript", 17, 0, 0, 0, 17
"c:\Users\dell\WebstormProjects\Gigsy_Digitopia2025\gigsy\src\app\app\courses\[courseId]\page.tsx", "TypeScript JSX", 0, 392, 44, 35, 471
"c:\Users\dell\WebstormProjects\Gigsy_Digitopia2025\gigsy\src\app\app\courses\page.tsx", "TypeScript JSX", 0, 310, 54, 32, 396
"c:\Users\dell\WebstormProjects\Gigsy_Digitopia2025\gigsy\src\app\app\layout.tsx", "TypeScript JSX", 0, -2, 0, 0, -2
"c:\Users\dell\WebstormProjects\Gigsy_Digitopia2025\gigsy\src\components\DynamicIcon.tsx", "TypeScript JSX", 0, 3, 0, 0, 3
"c:\Users\dell\WebstormProjects\Gigsy_Digitopia2025\gigsy\src\components\SkillsCheck.tsx", "TypeScript JSX", 0, 368, 20, 43, 431
"c:\Users\dell\WebstormProjects\Gigsy_Digitopia2025\gigsy\src\components\courses\CourseCard.tsx", "TypeScript JSX", 0, 434, 27, 35, 496
"c:\Users\dell\WebstormProjects\Gigsy_Digitopia2025\gigsy\src\components\courses\CourseFilters.tsx", "TypeScript JSX", 0, 439, 23, 33, 495
"c:\Users\dell\WebstormProjects\Gigsy_Digitopia2025\gigsy\src\components\courses\CourseList.tsx", "TypeScript JSX", 0, 360, 16, 29, 405
"c:\Users\dell\WebstormProjects\Gigsy_Digitopia2025\gigsy\src\components\courses\index.ts", "TypeScript", 11, 0, 12, 2, 25
"c:\Users\dell\WebstormProjects\Gigsy_Digitopia2025\gigsy\src\components\ui\form.tsx", "TypeScript JSX", 0, 1, 0, 0, 1
"c:\Users\dell\WebstormProjects\Gigsy_Digitopia2025\gigsy\src\hooks\use-mobile.ts", "TypeScript", 2, 0, 0, 0, 2
"c:\Users\dell\WebstormProjects\Gigsy_Digitopia2025\gigsy\src\lib\logging\hooks.ts", "TypeScript", 1, 0, 0, 0, 1
"c:\Users\dell\WebstormProjects\Gigsy_Digitopia2025\gigsy\src\lib\validations\courses.ts", "TypeScript", 542, 0, 124, 74, 740
"c:\Users\dell\WebstormProjects\Gigsy_Digitopia2025\gigsy\src\types\courses.ts", "TypeScript", 377, 0, 277, 190, 844
"c:\Users\dell\WebstormProjects\Gigsy_Digitopia2025\gigsy\src\types\skills.ts", "TypeScript", 7, 0, 0, 0, 7
"Total", "-", 1912, 2305, 748, 628, 5593