"filename", "language", "Markdown", "TypeScript JSX", "TypeScript", "comment", "blank", "total"
"c:\Users\dell\WebstormProjects\Gigsy_Digitopia2025\gigsy\convex\_generated\api.d.ts", "TypeScript", 0, 0, 2, 0, 0, 2
"c:\Users\dell\WebstormProjects\Gigsy_Digitopia2025\gigsy\convex\courses.ts", "TypeScript", 0, 0, -414, -71, -94, -579
"c:\Users\dell\WebstormProjects\Gigsy_Digitopia2025\gigsy\convex\schema.ts", "TypeScript", 0, 0, 9, 0, 0, 9
"c:\Users\dell\WebstormProjects\Gigsy_Digitopia2025\gigsy\docs\COURSE_CATALOG_README.md", "Markdown", 327, 0, 0, 0, 76, 403
"c:\Users\dell\WebstormProjects\Gigsy_Digitopia2025\gigsy\docs\COURSE_CATALOG_TECHNICAL_DOCS.md", "Markdown", 390, 0, 0, 0, 91, 481
"c:\Users\dell\WebstormProjects\Gigsy_Digitopia2025\gigsy\src\app\app\courses\__tests__\integration.test.tsx", "TypeScript JSX", 0, 356, 0, 22, 84, 462
"c:\Users\dell\WebstormProjects\Gigsy_Digitopia2025\gigsy\src\app\app\courses\page.tsx", "TypeScript JSX", 0, 12, 0, 0, 0, 12
"c:\Users\dell\WebstormProjects\Gigsy_Digitopia2025\gigsy\src\components\courses\CourseCard.tsx", "TypeScript JSX", 0, -251, 0, -16, -20, -287
"c:\Users\dell\WebstormProjects\Gigsy_Digitopia2025\gigsy\src\components\courses\VirtualizedCourseList.tsx", "TypeScript JSX", 0, 64, 0, 1, 8, 73
"c:\Users\dell\WebstormProjects\Gigsy_Digitopia2025\gigsy\src\components\courses\__tests__\CourseCard.test.tsx", "TypeScript JSX", 0, 283, 0, 17, 63, 363
"c:\Users\dell\WebstormProjects\Gigsy_Digitopia2025\gigsy\src\lib\performance\__tests__\courseOptimizations.test.ts", "TypeScript", 0, 0, 381, 18, 95, 494
"c:\Users\dell\WebstormProjects\Gigsy_Digitopia2025\gigsy\src\lib\performance\courseOptimizations.ts", "TypeScript", 0, 0, 252, 22, 51, 325
"Total", "-", 717, 464, 230, -7, 354, 1758