"filename", "language", "Markdown", "TypeScript", "TypeScript JSX", "comment", "blank", "total"
"c:\Users\dell\WebstormProjects\Gigsy_Digitopia2025\gigsy\LMS_QA_CHECKLIST.md", "Markdown", 0, 0, 0, 0, 28, 28
"c:\Users\dell\WebstormProjects\Gigsy_Digitopia2025\gigsy\LMS_README.md", "Markdown", 3, 0, 0, 0, 30, 33
"c:\Users\dell\WebstormProjects\Gigsy_Digitopia2025\gigsy\convex\courses.ts", "TypeScript", 0, 2, 0, 0, 0, 2
"c:\Users\dell\WebstormProjects\Gigsy_Digitopia2025\gigsy\convex\coursesMutations.ts", "TypeScript", 0, 2, 0, 0, 0, 2
"c:\Users\dell\WebstormProjects\Gigsy_Digitopia2025\gigsy\src\app\app\courses\CourseCatalogWrapper.tsx", "TypeScript JSX", 0, 0, 0, 0, 1, 1
"c:\Users\dell\WebstormProjects\Gigsy_Digitopia2025\gigsy\src\app\app\courses\[courseId]\CourseDetailsWrapper.tsx", "TypeScript JSX", 0, 0, 10, 0, 1, 11
"c:\Users\dell\WebstormProjects\Gigsy_Digitopia2025\gigsy\src\app\app\courses\[courseId]\lessons\[lessonId]\LessonClientWrapper.tsx", "TypeScript JSX", 0, 0, -1, -13, 0, -14
"c:\Users\dell\WebstormProjects\Gigsy_Digitopia2025\gigsy\src\app\app\courses\[courseId]\lessons\[lessonId]\page.tsx", "TypeScript JSX", 0, 0, 45, 2, 0, 47
"c:\Users\dell\WebstormProjects\Gigsy_Digitopia2025\gigsy\src\app\app\courses\[courseId]\page-fixed.tsx", "TypeScript JSX", 0, 0, -2, 0, 1, -1
"c:\Users\dell\WebstormProjects\Gigsy_Digitopia2025\gigsy\src\app\app\courses\[courseId]\page-new.tsx", "TypeScript JSX", 0, 0, 7, 0, 1, 8
"c:\Users\dell\WebstormProjects\Gigsy_Digitopia2025\gigsy\src\app\app\courses\[courseId]\page.tsx", "TypeScript JSX", 0, 0, 8, 0, 1, 9
"c:\Users\dell\WebstormProjects\Gigsy_Digitopia2025\gigsy\src\components\course\CourseHero.stories.tsx", "TypeScript JSX", 0, 0, 10, 0, 1, 11
"c:\Users\dell\WebstormProjects\Gigsy_Digitopia2025\gigsy\src\components\course\CourseHero.tsx", "TypeScript JSX", 0, 0, 23, 0, 1, 24
"c:\Users\dell\WebstormProjects\Gigsy_Digitopia2025\gigsy\src\components\course\CourseSummaryCard.tsx", "TypeScript JSX", 0, 0, 9, 0, 1, 10
"c:\Users\dell\WebstormProjects\Gigsy_Digitopia2025\gigsy\src\components\course\ModuleList.tsx", "TypeScript JSX", 0, 0, 27, 0, 1, 28
"c:\Users\dell\WebstormProjects\Gigsy_Digitopia2025\gigsy\src\components\course\__tests__\ModuleList.test.tsx", "TypeScript JSX", 0, 0, 9, 0, 1, 10
"c:\Users\dell\WebstormProjects\Gigsy_Digitopia2025\gigsy\src\components\course\__tests__\integration.test.tsx", "TypeScript JSX", 0, 0, -2, 0, 1, -1
"c:\Users\dell\WebstormProjects\Gigsy_Digitopia2025\gigsy\src\components\lesson\LessonPlayer.stories.tsx", "TypeScript JSX", 0, 0, -6, 0, 1, -5
"c:\Users\dell\WebstormProjects\Gigsy_Digitopia2025\gigsy\src\components\lesson\LessonPlayer.tsx", "TypeScript JSX", 0, 0, 33, 3, 5, 41
"c:\Users\dell\WebstormProjects\Gigsy_Digitopia2025\gigsy\src\components\lesson\LessonSidebar.tsx", "TypeScript JSX", 0, 0, 31, 0, 1, 32
"c:\Users\dell\WebstormProjects\Gigsy_Digitopia2025\gigsy\src\components\lesson\LessonViewer.tsx", "TypeScript JSX", 0, 0, 26, 2, 5, 33
"c:\Users\dell\WebstormProjects\Gigsy_Digitopia2025\gigsy\src\components\lesson\index.ts", "TypeScript", 0, 0, 0, 0, 1, 1
"c:\Users\dell\WebstormProjects\Gigsy_Digitopia2025\gigsy\src\components\ui\AvatarStackWrapper.tsx", "TypeScript JSX", 0, 0, 29, 0, 1, 30
"c:\Users\dell\WebstormProjects\Gigsy_Digitopia2025\gigsy\src\components\ui\ProgressRadial.tsx", "TypeScript JSX", 0, 0, 3, 0, 1, 4
"c:\Users\dell\WebstormProjects\Gigsy_Digitopia2025\gigsy\src\components\ui\slider.tsx", "TypeScript JSX", 0, 0, 17, 0, 1, 18
"c:\Users\dell\WebstormProjects\Gigsy_Digitopia2025\gigsy\src\hooks\useProgress.ts", "TypeScript", 0, 22, 0, 0, 1, 23
"c:\Users\dell\WebstormProjects\Gigsy_Digitopia2025\gigsy\src\schemas\course.ts", "TypeScript", 0, 65, 0, 0, 1, 66
"c:\Users\dell\WebstormProjects\Gigsy_Digitopia2025\gigsy\src\types\course.ts", "TypeScript", 0, 36, 0, 0, 1, 37
"c:\Users\dell\WebstormProjects\Gigsy_Digitopia2025\gigsy\src\utils\fetchers-client.ts", "TypeScript", 0, 23, 0, 0, 1, 24
"c:\Users\dell\WebstormProjects\Gigsy_Digitopia2025\gigsy\src\utils\fetchers-server.ts", "TypeScript", 0, 67, 0, 0, 1, 68
"c:\Users\dell\WebstormProjects\Gigsy_Digitopia2025\gigsy\src\utils\fetchers.ts", "TypeScript", 0, 377, 0, 39, 25, 441
"c:\Users\dell\WebstormProjects\Gigsy_Digitopia2025\gigsy\src\utils\format.ts", "TypeScript", 0, 3, 0, 0, 1, 4
"c:\Users\dell\WebstormProjects\Gigsy_Digitopia2025\gigsy\src\utils\time.ts", "TypeScript", 0, 23, 0, 0, 1, 24
"Total", "-", 3, 620, 276, 33, 117, 1049